R 1080 720

NO ./texture/mossy.xpm
SO ./texture/stone.xpm
WE ./texture/wood.xpm
EA ./texture/redbrick.xpm
S ./texture/pillar.xpm

F 220,100,0
C 225,30,0

        1111111111111111111111111
        1000000000110000000000001
        1011000001110000002000001
        1001000000000000000000001
111111111011000001110000000000001
100002000011000001110111110111111
11110111111111011100000010001
11110111111111011101010010001
11000000110101011100000010001
10002000000000001100000000001
10000000000000000001010010001
11000001110101011111011110N01
11110111 1001001 101111010001
11111111 1111111 111111111111